11111111111111111
109000000000000001
101111111011111101
100000000010000001
1000J0000001000T001
1000000111100000001
1000H0010000A0000001
1000000100000000001
1011110101111111101
1000M0001000000B00X1
1000000000000000001
11111111111111111