1111111111111
1900000000001
1011110111101
10G0000H00001
1010111011101
10M0000100001
1011101110101
1000000A00001
1010111011101
10N00000000B1
1011111111101
10000000000X1
1111111111111