11111111111111111
109000000000000001
101111011111110101
100000010000000001
1000J0010H000T0001
100000010001111001
10000001000S000001
101111011111110101
1000M000000000G0001
1000000000A000000X1
100000000000K000001
11111111111111111